################################
#..............................#
#..............................#
#..............................#
#..............................#
#..............................#
#..............................#
#..............................#
#..............................#
#..............................#
#.................##############
#.................##############
#..............................#
#..............................#
#..............................#
#..............................<
#.......###....................#
#...............###............#
#.....p........................#
#.......................########
>...........................####
#########...................####
###########........#############
################################